W W F W W  
W - - - W  
W B B B W  
W - U - W  
W W W W W  