W W W W W W W W W W
F - B H - - - I H W
W - - - - H - - W W
W W W W - - B W W W
W W - B H B B - W W
W U - - - - - - - W
W W W W W W W W W W
