W W W W W W W W
W B - B H B - W
F - - - H B U W
W - B B H B - W
W W W W W W W W
