W U W W W W
W - - - - W
W W - - - W
W - - - H W
W - - - - F
W W W W W W