W W W F W W
W - - B - W
W - - H B W
W B - - - W
W B H - B W
W - H B - W
W - U - - W
W W W W W W