W W W W W W W W
W B - B - - - W
F - B - B - U W
W - - B - B - W
W W W W W W W W