W W W W W W W 
W - - - B H W 
W U B H - - W 
W - - - - - F 
W - B B B - W 
W W W W W W W