W W W W W W W W
W B - B - - - W
F - - - H B U W
W - - B H B - W
W W W W W W W W