W W W W W W W 
W - - - - - W 
W U - - B - W 
W - - B - - F 
W - B - B - W 
W W W W W W W