W W W W W W W 
W - - B - B W 
W U B - B - W 
W - - B - B F 
W - B - B - W 
W W W W W W W