W W W W F W
W - - - - W
W - - - - W
W - - - - W
W U - - - W
W W W W W W