W W W W W W W W
W B - B - - - W
F - - - - B U W
W - - B - B - W
W W W W W W W W