W W W W W W
W W - - - W
W W - W - W
W - B - B W
W U W - - W
W W W F W W